              ####
###############  #
#     X   X   X  #
#   X   X   X #  #
##   ########## ##
 #O OOOOOOOOOOO O#
 ##X ########## ##
 #  # X   X   X  #
 #  X   X   X    #
 #  ########### P#
 ####         ####